1111111111111111111111111111
1E0000C00000C0000C0000C000C1
1010010111101000010000011001
1010010100001000010000100101
1010010100001000010000100101
1011110111101000010000100101
1010010100001000010000100101
1010010100001000010000100101
1010010111101111011110011001
1P0000C0000C0000C0000C0000C1
1111111111111111111111111111
