111111
10C011
1E10C1
111P11
111111
