11111111111111111
10C01000000000000
1E10C000000000001
011P1000000000001
11111111111111111
