11111111111111111
10C01000000000001
1E10C000000000001
01101000000000001
11111111111111111
