111111111111111100
10C0100000000011
1E10C00000000001
111P100000000001
1111111111111111
