111111111111111111111111111111111111111111111111111111111111
1E0000C00000C0000C0000C000C001111111111111111111111111111111
101001011110100001000001100111111111111111111111111111111111
101001010000100001000010010111111111111111111111111111111111
101001010000100001000010010111111111111111111111111111111111
101111011110100001000010010111111111111111111111111111111111
101001010000100001000010010111111111111111111111111111111111
101001010000100001000010010111111111111111111111111111111111
101001011110111101111001100111111111111111111111111111111111
1P0000C0000C0000C0000C0000C001111111111111111111111111111111
111111111111111111111111111111111111111111111111111111111111
111111111111111111111111111111111111111111111111111111111111
111111111111111111111111111111111111111111111111111111111111
111111111111111111111111111111111111111111111111111111111111
111111111111111111111111111111111111111111111111111111111111
111111111111111111111111111111111111111111111111111111111111
111111111111111111111111111111111111111111111111111111111111
111111111111111111111111111111111111111111111111111111111111
111111111111111111111111111111111111111111111111111111111111
111111111111111111111111111111111111111111111111111111111111
111111111111111111111111111111111111111111111111111111111111
111111111111111111111111111111111111111111111111111111111111
